DSDCOUNT - Total # of Dietary Supplements Taken
DSDANCNT - Total # of Antacids Taken
DSD010 - Any Dietary Supplements Taken?
DSD010AN - Any Antacids Taken?
DSQTKCAL - Energy (kcal)
DSQTPROT - Protein (gm)
DSQTCARB - Carbohydrate (gm)
DSQTSUGR - Total sugars (gm)
DSQTFIBE - Dietary fiber (gm)
DSQTTFAT - Total fat (gm)
DSQTSFAT - Total saturated fatty acids (gm)
DSQTMFAT - Total monounsaturated fatty acids (gm)
DSQTPFAT - Total polyunsaturated fatty acids (gm)
DSQTCHOL - Cholesterol (mg)
DSQTLYCO - Lycopene (mcg)
DSQTLZ - Lutein + zeaxanthin (mcg)
DSQTVB1 - Thiamin (Vitamin B1) (mg)
DSQTVB2 - Riboflavin (Vitamin B2) (mg)
DSQTNIAC - Niacin (mg)
DSQTVB6 - Vitamin B6 (mg)
DSQTFA - Folic acid (mcg)
DSQTFDFE - Folate, DFE (mcg)
DSQTCHL - Total choline (mg)
DSQTVB12 - Vitamin B12 (mcg)
DSQTVC - Vitamin C (mg)
DSQTVK - Vitamin K (mcg)
DSQTVD - Vitamin D (D2 + D3) (mcg)
DSQTCALC - Calcium (mg)
DSQTPHOS - Phosphorus (mg)
DSQTMAGN - Magnesium (mg)
DSQTIRON - Iron (mg)
DSQTZINC - Zinc (mg)
DSQTCOPP - Copper (mg)
DSQTSODI - Sodium (mg)
DSQTPOTA - Potassium (mg)
DSQTSELE - Selenium (mcg)
DSQTCAFF - Caffeine (mg)
DSQTIODI - Iodine (mcg)